{
  "id": 19,
  "title": "\u0423\u0440\u043E\u0432\u0435\u043D\u044C 19",
  "difficulty": 5,
  "exitEmoji": "\u2B50",
  "layout": [
    "#################",
    "#S....#.......#.#",
    "#####.####..#.#.#",
    "#...#.....#.#...#",
    "#.#.#####.#.###.#",
    "#.#.....#...#...#",
    "#.#.##..#####.###",
    "#E#...#.#...#.#.#",
    "#####.#.#.###.#.#",
    "#.....#...#...#.#",
    "#...#####.#.###.#",
    "#.#.#.....#.#...#",
    "#.###.###.#.###.#",
    "#.....#.#.#.#...#",
    "#.###.#.#.#.#.#.#",
    "#.......#.....#.#",
    "#################"
  ]
}