{
  "id": 14,
  "title": "\u0423\u0440\u043E\u0432\u0435\u043D\u044C 14",
  "difficulty": 4,
  "exitEmoji": "\uD83D\uDEAA",
  "layout": [
    "###############",
    "#S#...#.....#.#",
    "#.#.#.###.#.#.#",
    "#.#.#.....#...#",
    "#.#.#########.#",
    "#...#.........#",
    "###.#.######.##",
    "#.#...#..E#...#",
    "#.#.###.###.#.#",
    "#...#.......#.#",
    "#.###.#.#####.#",
    "#...#...#...#.#",
    "###.#####.#.#.#",
    "#.........#...#",
    "###############"
  ]
}