{
  "id": 12,
  "title": "\u0423\u0440\u043E\u0432\u0435\u043D\u044C 12",
  "difficulty": 3,
  "exitEmoji": "\uD83C\uDFC1",
  "layout": [
    "#############",
    "#S..#.......#",
    "###.#.#####.#",
    "#.#.#...#...#",
    "#.#.###.#.#.#",
    "#.#...#.#.#.#",
    "#.###.#.#.#.#",
    "#.#...#E#.#.#",
    "#.#.#####.#.#",
    "#.#.......#.#",
    "#.##.##.###.#",
    "#...........#",
    "#############"
  ]
}