{
  "id": 6,
  "title": "\u0423\u0440\u043E\u0432\u0435\u043D\u044C 6",
  "difficulty": 2,
  "exitEmoji": "\uD83C\uDFC1",
  "layout": [
    "###########",
    "#S....#...#",
    "#####.#.#.#",
    "#...#.#E#.#",
    "###.#.###.#",
    "#...#.#...#",
    "#.#.#.#.#.#",
    "#.#.#.#.#.#",
    "#.###.#.#.#",
    "#.......#.#",
    "###########"
  ]
}