{
  "id": 8,
  "title": "\u0423\u0440\u043E\u0432\u0435\u043D\u044C 8",
  "difficulty": 3,
  "exitEmoji": "\uD83D\uDEAA",
  "layout": [
    "#############",
    "#S......#...#",
    "#######.#.#.#",
    "#.#...#.#.#.#",
    "#.#.#.#.#.#.#",
    "#.#.#...#E#.#",
    "#.#.#######.#",
    "#.#.#.......#",
    "#.#.###.###.#",
    "#.#...#.#.#.#",
    "#.###.#.#.#.#",
    "#.......#...#",
    "#############"
  ]
}