{
  "id": 2,
  "title": "\u041F\u043E\u0432\u043E\u0440\u043E\u0442",
  "difficulty": 1,
  "exitEmoji": "\uD83D\uDEAA",
  "layout": [
    "###########",
    "#S........#",
    "#.#######.#",
    "#.......#.#",
    "#.#####.#.#",
    "#.....#...#",
    "#####.#..E#",
    "###########"
  ]
}