{
  "id": 4,
  "title": "\u041E\u0431\u0445\u043E\u0434",
  "difficulty": 2,
  "exitEmoji": "\uD83C\uDFC1",
  "layout": [
    "###############",
    "#S............#",
    "#.###########.#",
    "#.#.........#.#",
    "#.#.#######.#.#",
    "#.#.#.....#.#.#",
    "#.#.#.###.#.#.#",
    "#...#...#...#E#",
    "###############"
  ]
}