{
  "id": 3,
  "title": "\u0414\u0432\u0435 \u0434\u043E\u0440\u043E\u0436\u043A\u0438",
  "difficulty": 2,
  "exitEmoji": "\u2B50",
  "layout": [
    "#############",
    "#S....#.....#",
    "#.###.#.###.#",
    "#.#...#...#.#",
    "#.#.#####.#.#",
    "#.#.....#.#.#",
    "#.#####.#.#.#",
    "#.....#...#E#",
    "#############"
  ]
}