{
  "id": 20,
  "title": "\u0423\u0440\u043E\u0432\u0435\u043D\u044C 20",
  "difficulty": 5,
  "exitEmoji": "\uD83D\uDEAA",
  "layout": [
    "#################",
    "#S#.............#",
    "#..######.#####.#",
    "#.........#.....#",
    "###########.#.#.#",
    "#.....#.....#.#.#",
    "#.#.#.#.#####.#.#",
    "#.#.#.#...#...#.#",
    "#...#.###.#.#.#.#",
    "#.#.#...#.#.#.#.#",
    "#.#.#.###.#.###.#",
    "#.#.#.....#.#...#",
    "#.#.#######.#.###",
    "#...#...#.....#.#",
    "#.###.#.#.###.#.#",
    "#.....#E#.......#",
    "#################"
  ]
}